WWWWWWWWWWWWWWWWWW
W     S          W
W                W
W                W
W                W
W                W
W           B    W
W                W
W                W
W      A         W
W                W
WWWWWWWWWWWWWWWWWW